XXXXXXXXXXXXXXXXXXXXXXXXXXXXXXXXXXXXXXXX
XUOOOOOOOOOOOOOOOOUXXUOOOOOOOOOOOOOOOOUX
XOXXXXXXOXXXXXXXXXOXXOXXXXXXXXXOXXXXXXOX
XOXXXXXXOXXXXXXXXXOXXOXXXXXXXXXOXXXXXXOX
XOXXXXXXOXXXXXXXXXOXXOXXXXXXXXXOXXXXXXOX
XOOOOOOOOOOOOOOOOOOOOOOOOOOOOOOOOOOOOOOX
XOXXXXXXOXOXXXXXXXXXXXXXXXXXXOXOXXXXXXOX
XOXXXXXXOXOXXXXXXXXXXXXXXXXXXOXOXXXXXXOX
XOXXXXXXOXOOOOOOOOOOOOOOOOOOOOXOXXXXXXOX
XOOOOOOOOXXXXXXXXXXXXXXXXXXXXXXOOOOOOOOX
XXXXXXOXOXXXXXXXXXXXXXXXXXXXXXXOXOXXXXXX
XXXXXXOXOXXXXXXXXXXXXXXXXXXXXXXOXOXXXXXX
XXXXXXOXOXXXXXXXXXXXXXXXXXXXXXXOXOXXXXXX
XXXXXXOXOOOOOOOOOOOMOOOOOOOOOOOOXOXXXXXX
XXXXXXOXXXXXXXOXXXXXXXXXXOXXXXXXXOXXXXXX
XXXXXXUOOOOOOOOXXXXXXXXXXOOOOOOOOUXXXXXX
XXXXXXOXXXXXXXOXXXXGXXXXXOXXXXXXXOXXXXXX
XXXXXXOXOOOOOOOXXXXXXXXXXOOOOOOOXOXXXXXX
XXXXXXOXOXXXXXOXXXXXXXXXXOXXXXXOXOXXXXXX
XXXXXXOXOXXXXXOOOOOOOOOOOOXXXXXOXOXXXXXX
XOOOOOOXOXXXXXOXXXXXXXXXXOXXXXXOXOOOOOOX
XOXXXXXXOXXXXXOXXXXXXXXXXOXXXXXOXXXXXXOX
XOXXXXXXOXXXXXOXXXXXXXXXXOXXXXXOXXXXXXOX
XOOOOOOOOXXXXXOOOOPOOOOOOOXXXXXOOOOOOOOX
XXXOXXXXXXXXXXXXOXXXXXXOXXXXXXXXXXXXOXXX
XXXOXXXXXXXXXXXXOXXXXXXOXXXXXXXXXXXXOXXX
XOOOOOOOOOOOOOOOOOOXXOOOOOOOOOOOOOOOOOOX
XOXXXXXXXXXXXXXXXXOXXOXXXXXXXXXXXXXXXXOX
XUOOOOOOOOOOOOOOOOOXXOOOOOOOOOOOOOOOOOUX
XXXXXXXXXXXXXXXXXXXXXXXXXXXXXXXXXXXXXXXX