XXXXXXXXXXXXXXXXXXXXXXXXXXXXXXXXXXXXXXXX
XOOOOOOOOOOOOOOOOOOXXOOOOOOOOOOOOOOOOOOX
XOXXXXXXOXXXXXXXXXOXXOXXXXXXXXXOXXXXXXOX
XOXXXXXXOXXXXXXXXXOXXOXXXXXXXXXOXXXXXXOX
XOXXXXXXOXXXXXXXXXOXXOXXXXXXXXXOXXXXXXOX
XOOOOOOOOOOOOOOOOOOOOOOOOOOOOOOOOOOOOOOX
XOXXXXXXOXOXXXXXXXXXXXXXXXXXXOXOXXXXXXOX
XOXXXXXXOXOXXXXXXXXXXXXXXXXXXOXOXXXXXXOX
XOXXXXXXOXOOOOOOOOOOOOOOOOOOOOXOXXXXXXOX
XOOOOOOOOXXXXXXXXXXXXXXXXXXXXXXOOOOOOOOX
XXXXXXOXOXXXXXXXXXXXXXXXXXXXXXXOXOXXXXXX
OOOOOXOXOXXXXXXXXXXXXXXXXXXXXXXOXOXXXXXX
OOOOOXOXOXXXXXXXXXXXXXXXXXXXXXXOXOXXXXXX
OOOOOXOXOOOOOOOOOOOOOOOOOOOOOOOOXOXXXXXX
OOOOOXOXXXXXXXOXXXXXXXXXXOXXXXXXXOXXXXXX
OOOOOXOOOOOOOOOXOOOOOOOOXOOOOOOOOOXXXXXX
OOOOOXOXXXXXXXOXOOOGOOOOXOXXXXXXXOXXXXXX
OOOOOXOXOOOOOOOXOOOOOOOOXOOOOOOOXOXXXXXX
OOOOOXOXOXXXXXOXXXXXXXXXXOXXXXXOXOXXXXXX
XXXXXXOXOXXXXXOOOOOOOOOOOOXXXXXOXOXXXXXX
XOOOOOOXOXXXXXOXXXXXXXXXXOXXXXXOXOOOOOOX
XOXXXXXXOXXXXXOXXXXXXXXXXOXXXXXOXXXXXXOX
XOXXXXXXOXXXXXOXXXXXXXXXXOXXXXXOXXXXXXOX
XOOOOOOOOXXXXXOOOOOPOOOOOOXXXXXOOOOOOOOX
XXXOXXXXXXXXXXXXOXXXXXXOXXXXXXXXXXXXOXXX
XXXOXXXXXXXXXXXXOXXXXXXOXXXXXXXXXXXXOXXX
XOOOOOOOOOOOOOOOOOOXXOOOOOOOOOOOOOOOOOOX
XOXXXXXXXXXXXXXXXXOXXOXXXXXXXXXXXXXXXXOX
XOOOOOOOOOOOOOOOOOOXXOOOOOOOOOOOOOOOOOOX
XXXXXXXXXXXXXXXXXXXXXXXXXXXXXXXXXXXXXXXX